9	9	9	9	9	9	9	9	9	9	9	9	9	9	9	9	9	9	9	9	9	9	9	9	9	9	9	9	9	9	9	9	9	9	9	9	9	9	9	9	9	9	9	9	9	9	9	9	9	9	9	9	9	9	9	9	9	9	9	9	9	9	9	9
9	0	0	0	0	0	0	0	0	0	0	0	0	0	0	0	0	0	0	0	0	0	0	0	0	0	0	0	0	0	0	0	0	0	0	0	0	0	0	0	0	0	0	0	0	0	0	0	0	0	0	0	0	0	0	0	0	0	0	0	0	0	0	9
9	0	0	0	0	0	0	0	0	0	0	0	0	0	0	0	0	0	0	0	0	0	0	0	0	0	0	0	0	0	0	0	0	0	0	0	0	0	0	0	0	0	0	0	0	0	0	0	0	0	0	0	0	0	0	0	0	0	0	0	0	0	0	9
9	0	0	0	0	0	0	0	0	0	0	0	0	0	0	0	0	0	0	0	0	0	0	0	0	0	0	0	0	0	0	0	0	0	0	0	0	0	0	0	0	0	0	0	0	0	0	0	0	0	0	0	0	0	0	0	0	0	0	0	0	0	0	9
9	0	0	0	0	0	0	0	0	0	0	0	0	0	0	0	0	0	0	0	0	0	0	0	0	0	9	9	9	9	9	9	9	9	9	9	9	9	0	0	0	0	0	0	0	0	0	0	0	0	0	0	0	0	0	0	0	0	0	0	0	0	0	9
9	0	0	0	0	0	0	0	0	9	9	9	9	9	9	9	9	0	0	0	0	0	0	0	0	0	9	9	9	9	9	9	9	9	9	9	9	9	0	0	0	0	0	0	0	0	0	9	9	9	9	9	9	9	9	0	0	0	0	0	0	0	0	9
9	0	0	0	0	0	0	0	0	9	9	9	9	9	9	9	9	0	0	0	0	0	0	0	0	0	9	9	9	9	9	9	9	9	9	9	9	9	0	0	0	0	0	0	0	0	0	9	9	9	9	9	9	9	9	0	0	0	0	0	0	0	0	9
9	0	0	0	0	0	0	0	0	9	9	9	9	9	9	9	9	0	0	0	0	0	0	0	0	0	9	9	9	9	9	9	9	9	9	9	9	9	0	0	0	0	0	0	0	0	0	9	9	9	9	9	9	9	9	0	0	0	0	0	0	0	0	9
9	0	0	0	0	0	0	0	0	9	9	9	9	9	9	9	9	0	0	0	0	0	0	0	0	0	9	9	9	9	9	9	9	9	9	9	9	9	0	0	0	0	0	0	0	0	0	9	9	9	9	9	9	9	9	0	0	0	0	0	0	0	0	9
9	0	0	0	0	0	0	0	0	9	9	9	9	9	9	9	9	0	0	0	0	0	0	0	0	0	9	9	9	9	9	9	9	9	9	9	9	9	0	0	0	0	0	0	0	0	0	9	9	9	9	9	9	9	9	0	0	0	0	0	0	0	0	9
9	0	0	0	0	0	0	0	0	9	9	9	9	9	9	9	9	0	0	0	0	0	0	0	0	0	9	9	9	9	9	9	9	9	9	9	9	9	0	0	0	0	0	0	0	0	0	9	9	9	9	9	9	9	9	0	0	0	0	0	0	0	0	9
9	0	0	0	0	0	0	0	0	9	9	9	9	9	9	9	9	0	0	0	0	0	0	0	0	0	9	9	9	9	9	9	9	9	9	9	9	9	0	0	0	0	0	0	0	0	0	9	9	9	9	9	9	9	9	0	0	0	0	0	0	0	0	9
9	0	0	0	0	0	0	0	0	9	9	9	9	9	9	9	9	0	0	0	0	0	0	0	0	0	0	0	0	0	0	0	0	0	0	0	0	0	0	0	0	0	0	0	0	0	0	9	9	9	9	9	9	9	9	0	0	0	0	0	0	0	0	9
9	0	0	0	0	0	0	0	0	0	0	0	0	0	0	0	0	0	0	0	0	0	0	0	0	0	0	0	0	0	0	0	0	0	0	0	0	0	0	0	0	0	0	0	0	0	0	0	0	0	0	0	0	0	0	0	0	0	0	0	0	0	0	9
9	0	0	0	0	0	0	0	0	0	0	0	0	0	0	0	0	0	0	0	0	0	0	0	0	0	0	0	0	0	0	0	0	0	0	0	0	0	0	0	0	0	0	0	0	0	0	0	0	0	0	0	0	0	0	0	0	0	0	0	0	0	0	9
9	0	0	0	0	0	0	0	0	0	0	0	0	0	0	0	0	0	0	0	0	0	0	0	0	0	0	0	0	0	0	0	0	0	0	0	0	0	0	0	0	0	0	0	0	0	0	0	0	0	0	0	0	0	0	0	0	0	0	0	0	0	0	9
9	0	0	0	0	0	0	0	0	0	0	0	0	0	0	0	0	0	0	0	0	0	0	0	0	0	0	0	0	0	0	0	0	0	0	0	0	0	0	0	0	0	0	0	0	0	0	0	0	0	0	0	0	0	0	0	0	0	0	0	0	0	0	9
9	0	0	0	0	0	0	0	0	0	0	0	0	0	0	0	0	0	0	0	0	0	0	0	0	0	0	0	0	0	0	0	0	0	0	0	0	0	0	0	0	0	0	0	0	0	0	0	0	0	0	0	0	0	0	0	0	0	0	0	0	0	0	9
9	0	0	0	0	0	0	0	0	0	0	0	0	0	0	0	0	0	0	0	0	0	0	0	0	0	0	0	0	0	0	0	0	0	0	0	0	0	0	0	0	0	0	0	0	0	0	0	0	0	0	0	0	0	0	0	0	0	0	0	0	0	0	9
9	0	0	0	0	0	0	0	0	0	0	0	0	0	0	0	0	0	0	0	0	0	0	0	0	0	0	0	0	0	0	0	0	0	0	0	0	0	0	0	0	0	0	0	0	0	0	0	0	0	0	0	0	0	0	0	0	0	0	0	0	0	0	9
9	0	0	0	9	9	9	9	9	9	9	9	9	9	9	9	9	9	9	9	9	9	9	9	9	9	9	0	0	0	0	0	0	0	0	0	0	9	9	9	9	9	9	9	9	9	9	9	9	9	9	9	9	9	9	9	9	9	9	9	0	0	0	9
9	0	0	0	8	8	8	8	8	8	8	8	8	8	8	8	8	8	8	8	8	8	8	8	8	8	8	0	0	0	0	0	0	0	0	0	0	8	8	8	8	8	8	8	8	8	8	8	8	8	8	8	8	8	8	8	8	8	8	8	0	0	0	9
9	3	3	3	3	3	3	3	4	0	0	0	0	0	0	0	0	0	0	0	7	7	0	0	0	0	0	0	0	0	0	0	0	0	0	0	0	7	7	0	0	0	0	0	0	0	0	0	0	0	0	0	0	0	0	2	1	1	1	1	1	1	1	9
9	3	3	3	3	3	3	3	4	0	0	0	0	0	0	0	0	0	0	0	0	0	0	0	0	0	0	0	0	0	0	0	0	0	0	0	0	0	0	0	0	0	0	0	0	0	0	0	0	0	0	0	0	0	0	2	1	1	1	1	1	1	1	9
9	3	3	3	3	3	3	3	4	0	0	0	0	0	0	0	0	0	0	0	0	0	0	0	0	0	0	0	0	0	0	0	0	0	0	0	0	0	0	0	0	0	0	0	0	0	0	0	0	0	0	0	0	0	0	2	1	1	1	1	1	1	1	9
9	3	3	3	3	3	3	3	4	0	0	0	0	0	0	0	0	0	0	0	0	0	0	0	0	0	0	0	0	0	0	0	0	0	0	0	0	0	0	0	0	0	0	0	0	0	0	0	0	0	0	0	0	0	0	2	1	1	1	1	1	1	1	9
9	3	3	3	3	3	3	3	4	0	0	0	0	0	0	0	0	0	0	0	0	0	0	0	0	0	0	0	0	0	0	0	0	0	0	0	0	0	0	0	0	0	0	0	0	0	0	0	0	0	0	0	0	0	0	2	1	1	1	1	1	1	1	9
9	3	3	3	3	3	3	3	4	0	0	0	0	0	0	0	0	0	0	0	0	0	0	0	0	0	0	0	0	0	0	0	0	0	0	0	0	0	0	0	0	0	0	0	0	0	0	0	0	0	0	0	0	0	0	2	1	1	1	1	1	1	1	9
9	3	3	3	3	3	3	3	4	0	0	0	0	0	0	0	0	0	0	0	0	0	0	0	0	0	0	0	0	0	0	0	0	0	0	0	0	0	0	0	0	0	0	0	0	0	0	0	0	0	0	0	0	0	0	2	1	1	1	1	1	1	1	9
9	9	9	0	0	0	9	9	9	9	9	9	9	9	9	0	0	0	0	9	9	9	9	9	9	9	9	0	0	0	0	0	0	0	0	0	0	9	9	9	9	9	9	9	9	0	0	0	0	9	9	9	9	9	9	9	9	9	0	0	0	9	9	9
9	9	9	0	0	0	9	9	9	9	9	9	9	9	9	0	0	0	0	9	9	9	9	9	9	9	9	0	0	0	0	0	0	0	0	0	0	9	9	9	9	9	9	9	9	0	0	0	0	9	9	9	9	9	9	9	9	9	0	0	0	9	9	9
9	9	9	0	0	0	9	9	9	9	9	9	9	9	9	0	0	0	0	9	9	9	9	9	9	9	9	0	0	0	0	0	0	0	0	0	0	9	9	9	9	9	9	9	9	0	0	0	0	9	9	9	9	9	9	9	9	9	0	0	0	9	9	9
9	9	9	0	0	0	9	9	9	9	9	9	9	9	9	0	0	0	0	9	9	9	9	9	9	9	9	0	0	0	0	0	0	0	0	0	0	9	9	9	9	9	9	9	9	0	0	0	0	9	9	9	9	9	9	9	9	9	0	0	0	9	9	9
9	9	9	0	0	0	9	9	9	9	9	9	9	9	9	0	0	0	0	9	9	9	9	9	9	9	9	0	0	0	0	0	0	0	0	0	0	9	9	9	9	9	9	9	9	0	0	0	0	9	9	9	9	9	9	9	9	9	0	0	0	9	9	9
9	9	9	0	0	0	9	9	9	9	9	9	9	9	9	0	0	0	0	9	9	9	9	9	9	9	9	0	0	0	0	0	0	0	0	0	0	9	9	9	9	9	9	9	9	0	0	0	0	9	9	9	9	9	9	9	9	9	0	0	0	9	9	9
9	9	9	0	0	0	9	9	9	9	9	9	9	9	9	0	0	0	0	9	9	9	9	9	9	9	9	0	0	0	0	0	0	0	0	0	0	9	9	9	9	9	9	9	9	0	0	0	0	9	9	9	9	9	9	9	9	9	0	0	0	9	9	9
9	9	9	0	0	0	9	9	9	9	9	9	9	9	9	0	0	0	0	9	7	7	9	9	9	9	9	0	0	0	0	0	0	0	0	0	0	9	9	9	9	9	9	9	9	0	0	0	0	9	9	9	9	9	9	9	9	9	0	0	0	9	9	9
9	0	0	0	0	0	0	0	0	0	0	0	0	0	0	0	0	0	0	0	0	0	0	7	7	0	0	0	0	0	0	0	0	0	0	0	0	0	0	0	0	0	0	0	0	0	0	0	0	0	0	0	0	0	0	0	0	0	0	0	0	0	0	9
9	0	0	0	0	0	0	0	0	0	0	0	0	0	0	0	0	0	0	0	0	0	0	0	0	0	0	0	0	0	0	0	0	0	0	0	0	0	0	0	0	0	0	0	0	0	0	0	0	0	0	0	0	0	0	0	0	0	0	0	0	0	0	9
9	0	0	0	0	0	0	0	0	0	0	0	0	0	0	0	0	0	0	0	0	0	0	0	0	0	0	0	0	0	0	0	0	0	0	0	0	0	0	0	0	0	0	0	0	0	0	0	0	0	0	0	0	0	0	0	0	0	0	0	0	0	0	9
9	0	0	0	0	0	0	0	0	0	0	0	0	0	0	0	0	0	0	0	0	0	0	0	0	0	0	0	0	0	0	0	0	0	0	0	0	0	0	0	0	0	0	0	0	0	0	0	0	0	0	0	0	0	0	0	0	0	0	0	0	0	0	9
9	0	0	0	0	0	0	0	9	9	9	9	9	9	9	9	9	9	9	9	9	9	9	9	9	9	9	9	9	9	9	9	9	9	9	9	9	9	9	9	9	9	9	9	9	9	9	9	9	9	9	9	9	9	9	9	0	0	0	0	0	0	0	9
9	0	0	0	0	0	0	0	9	9	9	9	9	9	9	9	9	9	9	9	9	9	9	9	9	9	9	9	9	9	9	9	9	9	9	9	9	9	9	9	9	9	9	9	9	9	9	9	9	9	9	9	9	9	9	9	0	0	0	0	0	0	0	9
9	0	0	0	0	0	0	0	9	9	9	9	9	9	9	9	9	9	9	9	9	9	9	9	9	9	9	9	9	9	9	9	9	9	9	9	9	9	9	9	9	9	9	9	9	9	9	9	9	9	9	9	9	9	9	9	0	0	0	0	0	0	0	9
9	0	0	0	0	0	0	0	9	9	9	9	9	9	9	9	9	9	9	9	9	9	9	9	9	9	9	9	9	9	9	9	9	9	9	9	9	9	9	9	9	9	9	9	9	9	9	9	9	9	9	9	9	9	9	9	0	0	0	0	0	0	0	9
9	0	0	0	0	0	0	0	9	9	9	9	9	9	9	9	9	9	9	9	9	9	9	9	9	9	9	9	9	9	9	9	9	9	9	9	9	9	9	9	9	9	9	9	9	9	9	9	9	9	9	9	9	9	9	9	0	0	0	0	0	0	0	9
9	0	0	0	0	0	0	0	9	9	9	9	9	9	9	9	9	9	9	9	9	9	9	9	9	9	9	9	9	9	9	9	9	9	9	9	9	9	9	9	9	9	9	9	9	9	9	9	9	9	9	9	9	9	9	9	0	0	0	0	0	0	0	9
9	0	0	0	0	0	0	0	0	0	0	0	0	0	0	0	0	0	0	0	0	0	0	0	0	0	0	0	0	0	0	0	0	0	0	0	0	0	0	0	0	0	0	0	0	0	0	0	0	0	0	0	0	0	0	0	0	0	0	0	0	0	0	9
9	0	0	0	0	0	0	0	0	0	0	0	0	0	0	0	0	0	0	0	0	0	0	0	0	0	0	0	0	0	0	0	0	0	0	0	0	0	0	0	0	0	0	0	0	0	0	0	0	0	0	0	0	0	0	0	0	0	0	0	0	0	0	9
9	0	0	0	0	0	0	0	0	0	0	0	0	0	0	0	0	0	0	0	0	0	0	0	0	0	0	0	0	0	0	0	0	0	0	0	0	0	0	0	0	0	0	0	0	0	0	0	0	0	0	0	0	0	0	0	0	0	0	0	0	0	0	9
9	0	0	0	0	0	0	0	0	0	0	0	0	0	0	0	0	0	0	0	0	0	0	0	0	0	0	0	0	0	0	0	0	0	0	0	0	0	0	0	0	0	0	0	0	0	0	0	0	0	0	0	0	0	0	0	0	0	0	0	0	0	0	9
9	9	9	9	9	9	9	9	9	9	9	9	9	9	9	9	9	9	9	9	9	9	9	9	9	9	9	9	9	9	9	9	9	9	9	9	9	9	9	9	9	9	9	9	9	9	9	9	9	9	9	9	9	9	9	9	9	9	9	9	9	9	9	9
